R 1440 840

NO ./texture/birch_wood.xpm
SO ./texture/oak_wood.xpm
EA ./texture/tnt.xpm
WE ./texture/grass.xpm

S ./texture/cactus.xpm
T ./texture/portal.xpm


F 100 240 100
C 100 100 240

                    1111111111111111111111111111
                    1000000000000000000000000001
                    1000002000000000000000000001
                    1000000000000300000000000001
                    1000000000000000000000000001
                    1000000000000000000000002001
                    1000000200000000000000000001
                    1111111111111000111111111111
                                10001
                                10001
                                10001
11111111111111            11111110001
12200030000221            10000000001
12000000000021            10002000001
10000000000001            10000000001
100000N0000001            10001111111
1000000000000111          10001
1000000000000221          100011111111111111
1000000000000221          100000000000000021
1200000000000021          122000000000000021
1220000000000221          122000000000000021
11111111100011111111111111111111111111000111
    10000000000000000000000000000000000001
    10000000000000000000000000000000002001
    10000000111111100000000200000000000001
    111111111     100000000000000000000001
                  100000000000000000000001
                  100002000000000000000001
                  100000000000000200000001
                  100200000200000000000001
                  100000000000000000002001
                  111111111111111111111111
