R 10000 10000

NO ./texture/greystone.xpm
SO ./texture/mossy.xpm
EA ./texture/redbrick.xpm
WE ./texture/wood.xpm

S ./texture/barrel.xpm

F 100 100 100

C 200 200 200



111111111
122222221
122222221
122222221
1222E2221
122222221
122222221
122222221
111111111