R 640 480

NO ./ft_parcing.h
SO ./ft_print_error.c
EA ./ft_test.c
WE ./random test

S other yolo

F 220 210 200

C 120 110 100


                  111111111111111111111111
                  100000200000000000000001
    11111         100000000000000000000001
    10001         100000000000020000000001
    10001         100000000000000000000001
    10001         101111111111111111111111
    10001         101
111110001111111   101    111111
1000000000000011111011111100001
102000N000000000000000000000001
1000000000000011111111011100001
111110001111111000000001 111111
    10001     1000000001
    10001     10000000011111111
    10001     10000000000000001
    10001     10000002000000001
    11111     10000000000000001
              11111111111111111