R 10000 10000

NO ./texture/greystone.xpm
SO ./texture/colorstone.xpm
EA ./texture/eagle.xpm
WE ./texture/bluestone.xpm

S ./texture/cactus.xpm
T ./texture/portal.xpm


F 100 240 100
C 100 100 240

111111111111111111111111111111111111111111
120000000000000000000000000000000000000021
100000000000000000000000000000000000000001
10000000000000000000N000000000000000000001
100000000000000000000000000000000000000031
100000000000000000000000000000000000000001
120000000000000000000000000000000000000021
111111111111111111111111111111111111111111
111111111111111111111111111111111111111111
120000000000000000002000000000000000000021
100000000000000000002000000000000000000001
100000000000000000002000000000000000000031
100000000000000000002000000000000000000001
100000000000000000002000000000000000000001
120000000000000000002000000000000000000021
111111111111111111111111111111111111111111
