R 1920 1080

NO ./texture/bluestone.xpm
SO ./texture/redbrick.xpm
EA ./texture/wood.xpm
WE ./texture/colorstone.xpm

S ./texture/barrel.xpm

F 100 100 100

C 200 200 200



                    1111111111111111111111111111
                    1000000000000000000000000001
                    1000000000000000000000000001
                    1000000000000000000000000001
                    1000000000000000000000000001
                    1000000000000000000000000001
                    1000000000000000000000000001
                    1111111111111000111111111111
                                10001
                                10001
                                10001
11111111111111            11111110001
122000E0000221            10000000001
12000000000021            10000000001
10000000000001            10000000001
10000020000001            10001111111
10000020000001            10001
10000020000001111111111111100011111111111111
10000000000000000000000000000000000000000001
10000000000000000000000000000000000000000001
10000000000000000000000000000000000000000001
11111111100011111111111111111111111111111111
    10000000000000000000000000000000000001
    10000000000000000000000000000000000001
    10000000111111100000000000000000000001
    111111111     100000000000000000000001
                  100000000000000000000001
                  100000000000000000000001
                  100000000000000000000001
                  100000000000000000000001
                  100000000000000000000001
                  111111111111111111111111