R 640 480

NO ./ft_parcing.h
SO ./ft_print_error.c
EA ./ft_test.c
WE ./random test

S other yolo

F 0 0 0

C 0 0 0



                    1111111111111111111111111110
                    1000000000000000000000000001
                    1000002000000000000000000001
                    1000000000000000000000000001
                    1000000000000000000000000001
                    1000000000000000000000000001
                    1000000000000000000000000001
                    1111111111111000111111111111
                                10001
                                10001
                                10001
11111111111111            11111110001
10000000000001            10000000001
10200000000201            10000000001
10000000000001            10000000001
10000000000001            10001111111
1000000N000001            10001
10000000000001111111111111100011111111111111
10000000000000000000000000000000000000000001
10000000000000000000000000000000000000000001
10200000000000000000000000000000000000000001
11111111100011111111111111111111111111111111
100000000000100000000000000000000000000001
100000000000100000000000000000000000000001
100000000000111111100000000000000000000001
1000111111111     100000000000002000000001
10001             100000000000000000000001
100011111112111111100000000000000000000001
100000000000000000000000000000000000000001
100000000000000000000000000000000000000001
100000000000000000000000000000000000000001
111111111111111111111111111111111111111111