R 1280 720

NO ./texture/bluestone.xpm
SO ./texture/greystone.xpm
EA ./texture/mossy.xpm
WE ./texture/purplestone.xpm

S ./texture/barrel.xpm

F 100 100 100

C 200 200 200



                    1111111111111111111111111110
                    1000000000000000000000000001
                    1000002000000000000000000001
                    1000000000000000000000000001
                    1000000000000000000000000001
                    1000000000000000000000000001
                    1000000000000000000000000001
                    1111111111111000111111111111
                                10001
                                10001
                                10001
11111111111111            11111110001
10000000000001            10000000001
10203044030201            10000000001
10000000000001            10000000001
10000000000001            10001111111
1000000N000001            10001
10000000000001111111111111100011111111111111
10000000000000000000000000000000000000000001
10000000000000000000000000000000000000000001
10200000000000000000000000000000000000000001
11111111100011111111111111111111111111111111
    10000000000000000000000000000000000001
    10000000000000000000000000000000000001
    10000000111111100000000000000000000001
    111111111     100000000000002000000001
                  100000000000000000000001
                  100000000000000000000001
                  100000000000000000000001
                  100000000000000000000001
                  100000000000000000000001
                  111111111111111111111111