R 1460 860

NO ./texture/birch_wood.xpm
SO ./texture/oak_wood.xpm
EA ./texture/tnt.xpm
WE ./texture/grass.xpm

S ./texture/cactus.xpm
T ./texture/portal.xpm


F 100 240 100
C 100 100 240

                    1111111111111111111111111111
                    1000000000000000000000000001
                    1000000000000000000000000001
                    1000000000000000000000000001
                    1000000000000000000000000001
                    1000000000000000000000000001
                    1000000000000000000000000001
                    1111111111111000111111111111
                                10001
                                10001
                                10001
11111111111111            11111110001
10000030000221            10000000001
10000000000021            10000000001
10000000000001            10000000001
100000N0000001            10001111111
10000000000001            10001
10000000000001111111111111100011111111111111
10000000000000000000000000000000000000000001
10000000000000000000000000000000000000000001
10000000000000000000000000000000000000000001
11111111100011111111111111111111111111111111
    10000000000000000000000000000000000001
    10000000000000000000000000000000000001
    10000000111111100000000000000000000001
    111111111     100000000000000000000001
     11111        100000000000000000000001
     12221        100000000000000000000001
     12321        100000000000000000000001
     12221        100000000000000000000001
     11111        100000000000000000000001
                  111111111111111111111111
