R 10000 10000

NO ./texture/oak_wood.xpm
SO ./texture/grass.xpm
EA ./texture/tnt.xpm
WE ./texture/birch_wood.xpm

S ./texture/cactus.xpm
T ./texture/barrel.xpm
F 100 240 100

C 100 100 240

                    1111111111111111111111111111
                    1000000000000000000000000001
                    100000000000000000000000001
                    1000000000000030000000000001
                    1002000000000000000000000001
                    1000000000000000000000000001
                    1000000000000000000000000001
                    1111111111111000111111111111
                                10001
                                10001
                                10001
11111111111111            11111110001
10000000000001            10000000001
10000000000001            10000000001
10000000000001            10000000001
10000000000001            10001111111
10000030000001            10001
10000000000001111111111111100011111111111111
100000N0000000000000000000000000000000000001
10000000000000000000000000000000000000000001
10000000000000000000000000000000000000000001
11111111100011111111111111111111111111111111
    10000000000000000000000000000000000001
    10000000000000000000000000000000000001
    10000000111111100000000000000000000001
    111111111     100000000000000000000001
                  100000000000000000000001
                  100000000000000000000001
                  100000000000000000000001
                  100000000000000000000001
                  100000000000000000000001
                  111111111111111111111111